advertisement	Where can someone find a shiny advertisement?	|commercial|magazine|mail|product
air	Where might I find air to fill up these balloons?	|earth|gas|ground|rock|sky|space|stuff|water
airplanes	Where do airplanes usually go?	|airplane|clouds|plane
alcohol	Where would a person light alcohol on fire to observe the reaction?	|beer|bottle|drink|wine
anger	The situation was causing anger, but his wife subdued it with her heartwarming what?	|anguish|anxiety|frustration|pain|panic|violence
arkansas	What country is arkansas in?	|florida|minnesota
audience	A member of the audience was struck in the head by a ball. What sort of building is the audience most likely in?	|auditorium|band|concert|crowd|movie|show|stage|theater
auditorium	What would I call a bunch of people I see in an auditorium?	|audience|chairs|concert|library|musical|show|stage|theater
automobile	Where would a person put an automobile when not using it?	|car|cars|driveway|freeway|highway|store
ball	The ball was in Lucy's court, which was good, since she played handball here all the time.  Where might she be/	|balloon|club|court|game|play|playing|stage|trouble
bar	Where do you go to a bar?	|beer|club|house|market|office|party|restaurant|wine
bbq	Where is the closest place you would cook bbq?	|backyard
beautiful	Where would you go if you want to see a beautiful thunderstorm?	|bad|beauty|good
beaver	The beaver swam through the country he symbolized, where was he likely to be?	|pond|sweat
bed	What does one do in bed?	|bedroom|couch|floor|house|room|sleep|table|television
bee	Where do bees go to find wildflowers?	|animals|barn|bird|cow|fly|garden|outside|tree
beer	Where is beer drank by people watching sticks and pucks?	|alcohol|bar|bottle|can|drinking|liquid|wine
bicycle	Where is the best place to get a bicycle for a child?	|automobile|cars|highway
bird	A bird flew but couldn't find any building to land on, where was it?	|airplane|bee|birds|fly|ground|nest|sky|wings
birds	Where are birds likely most happy?	|bird|plane
blanket	Where is a blanket useful to cover a horse?	|bed|clothes
blood	The vet was concerned about all of the blood he saw, where was the blood coming from?	|body|bone|heart|injury|water
boat	Where would using a boat not require navigation skills?	|aircraft|airplane|bay|car|ocean|river|sea|ship
bone	Where could you see a bone?	|arm|army|blood|body|mouth|skin
book	What can you use to store a book while traveling?	|article|books|desk|dictionary|floor|library|magazine|paper
books	Where can books be read?	|book|dictionary|library|magazine|magazines|shelf
bowl	Where do you put a bowl after it is used?	|cabinet|container|cup|food|glass|pizza|plate|plates
box	John knew that the pictures were in a box, he put them there for long term storage.  He went out and looked for it in what?	|ball|book|case|paper|stick|wood
boxes	Where should I not put these boxes if my house is likely to flood?	|basement|cellar
bread	When is good time for garlic bread?	|desert|fish|food|pie|plate|product|soup
bubblegum	The bad man tossed his bubblegum out of his window and onto the what?	|sweetness
building	Where is building likely to be rapid?	|apartment|chairs|city|court|house|skyscraper
bungalow	What is a group of bungalows in a small area?	|bedroom|cottage|house|suburbs
bus	Where might you use a bus to get around?	|car|road|sidewalk|street
candy	Where would you buy candy and other foods?	|chocolate|movie|peanuts
carpet	Where might carpet help your feet stay warm?	|basement|bathroom|bedroom|ceiling|floor|rug|shoes|tile
carrots	Where do most people get carrots?	|groceries|salad
cat	If you own a cat where is the last place you'd want to find it?	|carpet|dog|floor|garden|mouse|room|squirrel|table
ceiling	If someone is looking at a ceiling in their bedroom, where are they likely located?	|carpet|furniture|roof|rooms|tent|tile|wall
celebrating	If they were celebrating the occasion, how could the occasion be described?	|drinking|happiness|joy|kissing|party
chair	Where do students sit in chairs for large meeetings?	|bar|bench|couch|desk|floor|room|stage|table
chairs	Where would you buy a ticket to sit in a room with a lot of chairs facing the same direction?	|building|carpet|employees|meeting|paperwork
change	Where would you put your change if you plan to use it soon and you are a man?	|body|communication|competition|cooking|exchange|money|motion|wallet
channel	James tore the antenna off of his boat due to bad reception as he was crossing the channel from France.  Where was he going?	|asia|russia|valley
cheese	Where can someone go and buy cheese?	|food|fruit|pizza|refrigerator
chicken	On what is your chicken usually presented to you?	|bird|cow|farm|food|nest|plate|soup|squirrel
chocolate	Where would I put some chocolate after buying it?	|candy|container|food|sugar
churchyard	Sam found himself in a small churchyard surrounded by tall buildings.  Where might he have been?	|village
city	A city like Detroit ended up with a lot of abandoned buildings when large amounts of people moved where?	|continent|country|factory|farm|office|state|town|village
climbing	Climbing is quite a talent, it requires the use of very particular whats?	|exercise|exercising|strength
clock	What could you use to store a clock?	|desk|lamp|plate|shelf|table|time
closet	Where are you likely to find a large closet?	|cabinet|house|motel|room|toilet
clothes	Where is the best place for nice clothes?	|blanket|closet|clothing|dresser|stuff
clothing	James got clothing for Christmas.  He folded it carefully and put it somewhere. Where might he has put it?	|clothes|dresser|shoes
colorado	Colorado is two states away from the border with what nation?	|california|channel|kentucky|texas|town
communicating	The couple explained they were having trouble communicating, it seemed every conversation took great what?	|knowledge|learning|pencils|remembering|talk|talking|understanding
competing	Who is someone competing against?	|competition|defeat
computer	Where would you put a laptop computer if you want to use it outside?	|act|communication|table
condiments	Where would you put condiments to stop them from combining with other condiments?	|container
confusion	The general apologized for the confusion that led to loss of soldiers' lives. so what was happening that cause the deaths?	|understanding|violence
connection	She used her connections to get an interview, where did she want to work?	|shoes|wires
container	Where are you likely to find a tupperware container?	|cabinet|cupboard|pantry
contemplating	He was contemplating a choice, what was he doing the following day?	|intelligence|learning|mind|reflection|remembering|think|thinking|understanding
continent	What is an example of a continent?	|city|country|earth|government|island|ocean|place|region
cottage	There was a long cottage somewhere.  People thought it was haunted.  It was overgrown, there was nothing near it.  It's was far into the what?	|attic|barn|house|palace|village
country	The country has deserts, forests, and plains; You could say it has many a what?	|army|bank|city|continent|house|place|region|state
court	Where is one likely to find a tennis court?	|building|field|furniture|office|park|place|region|table
cow	Where do cows beef rank first in the country?	|barn|beaver|farm|horse|mouse|ranch|stable
creek	A creek is a body of water found in what low land?	|stream|swamp
cup	Where do you have someone who is always refilling your cup?	|bottle|cabinet|dishwasher|drinking|glass|lemonade|liquid|plates
dancing	Dancing or walking too much will lead to what on your feet?	|dance|entertainment|motion|performing
darkness	Billy didn't like the darkness.  It was so dark that he couldn't make out any action.  He thought that these would be better quality.	
death	In times of peace, in what building is it most likely that one encounters death?	|dead|die|funeral|kill|killing|morgue|sadness
dictionary	Where would you expect to find a dictionary along side other writings you can borrow?	|book|books|encyclopedia|library|magazine
dirt	If I wanted to grow plants, where could I put a lot of dirt?	|carpet|dust|floor|ground|rock|rug|shoes
dishes	Where can you store your dishes in your dwelling?	|pantry|plates
dog	Billy saw a dog running from him and did his best to get away from it.  The leaped up to where the dog couldn't reach and was stuck.  Where might he have been trapped?	|cat|earth|fox|heaven|home|horse|human|room
door	Where would a person blush or put his head down after shutting a door loudly?	|computer|gate|home|house|office|room|wall|window
doorway	What doorway is likely to have a large wooden door?	|door|gate|palace|porch
drink	What might help if my dog wants a drink but his bowl is empty?	|bar|beer|can|closet|continent|food|liquid|water
driveway	What part of a property may be next to a driveway?	|flat|freeway|highway|roadway|suburb
drugs	James didn't know what drugs he did.  They were being passed around and he just took one.  It was the last time he would go to such a wild what?	
dust	What do you clean dust off of to see more clearly?	|blanket|book|carpet|dirt|floor|rug|space|table
earth	What type of plant is the tallest found on earth?	|city|continent|ground|heaven|home|house|sky|world
electricity	Why did the heavy metal band need electricity at the stadium?	|chapel|current|energy|furniture|shock
elevator	Where is music likely to be playing in a elevator?	|stairs
employees	Where do employees spend most of their time working?	|meeting|workplace
entertaining	The man had been entertaining his whole life, being in his nineties now doing a show can lead to what?	|boredom|fun|happiness|laugh|laughter|playing
excavation	The excavation workers had to take extra care to stay hydrated, what landscape might they be working?	
exercising	Exercising daily requires a lot of what mental toughness?	|exercise|exhaustion|fatigue|run
families	Where might families decide on dinner together?	
ficus	Where would you put a ficus if you want to protect it from the rain?	|dirt|grass|ground|plants|pond
film	John likes Disney films and there was nothing good on, so he decided to see what?	|cinema|movie
fish	What kind of box does a fish live in?	|bird|bread|food|ocean|sea|soup|stream|water
flat	Where might someone find a very nice flat?	|driveway|garage
fleas	Hers pets had fleas, not only did she have to treat them but the furniture and what too?	|carpet|rug
floor	What floor do you run between rooms?	|basement|book|carpet|foot|ground|room|rug|space
flower	Where is a great place to display a flower on a table?	|beauty|color|flowers|garden|grass|plants
flowers	Flowers make a good center focal point, just one of many arrangements that look good on a what?	|apples|flower|lawn|plants|vase
food	Where is shelf stable food stored?	|beer|bread|can|dinner|fruit|jar|pizza|plate
foot	Where would you put your foot if it is already covered in cloth?	|arm|body|chair|floor|ground|run|shoe|sock
fox	John saw a fox running along the beach and was glad to be on the east coast.  Where might he have been?	|bee|cat|dog|forest|horse
freeway	The freeway had no traffic and few buildings, where is it?	|highway|road|roadway
frisbee	Where is a frisbee in play likely to be?	|ball|clouds|leaves|playing
furniture	The bachelor didn't have much furniture, but it at least made his small what look more spacious?	|bedroom|ceiling
garbage	where do you throw garbage?	|sewer|trash
gentleman	Where can I go to be a religious gentleman?	|suit
getting	What are you getting from you boss at the end of the week?	|joy|vault
glass	Glass is used to build these so you can see outside.	|door|paint|plate|rock|tree|water|window|wood
glasses	Where would glasses be needed by many people?	|beer|cage|peanuts
god	I you believe in god, where will you go when you die?	|body|church|heaven|universe
government	What does the government have control over?	|act|communication|control|country|germany|state
grape	They needed grape juice for their party, they went to buy it and other snacks at the what?	|cow|food|fruit|grass|market|ranch|wine
groceries	Where would you go if you need some groceries?	
grooming	Why might you be found grooming yourself in the mirror on the way out the door?	|beauty
ground	What in the building is very far from the ground floor?	|air|basement|earth|floor|foot|garden|grass|sky
hairbrush	Denny couldn't find his hairbrush.  He looked everywhere for it.  Under and over, up and down, it was not where he thought it would be.  So he closed the door behind him and continued his systematic search.  Where might Denny have looked first?	|bathroom|bedroom|flat|rooms
happiness	What can someone feeling happiness fall into?	|joy|laughter|pleasure|satisfaction
horse	The horse wanted to graze, where did it need to go?	|bone|city|color|country|dog|farm|field|ranch
house	I house outside the center of a community is said to be where?	|building|bus|car|city|country|place|sidewalk|street
human	Where may a human find peace?	|body|city|country|doctor|home|student|television|war
humans	Where can humans have a cup of coffee or a sandwich?	|die|kill|laugh|party|people|performing
illness	Where is the flu likely to result in illness?	|stomach
information	Where might I get written information on a past event?	|concert|internet|knowledge|newspaper
isle	Where can you watch a show about an isle?	|bay|island|lake|ocean|sea|swamp
jellyfish	Where could a jellyfish stay alive?	|jungle|ocean
junk	James took the junk off of the place where he sleeps and threw it into what?	|shoes
key	The big man was all size and no talent, but the coach taught him to defend the key and make it his home on the what?	|door|gate|locker
kissing	What does kissing lead to?	|entertaining|fun|laughter|love|pleasure|remembering|sex
knowledge	Making a schedule was easy to pick, the major called for knowledge that required a certain what?	|books|dictionary|education|information|intelligence|learning|understanding|university
lamp	John stumbled in the dark trying to find a lamp, but there wasn't one nearby.   It was late and everything was dark.  The entire what was pitch black.	|bedroom|book|candle|clock|floor|light|rooms|shelf
lasagna	Where would you look for lasagna after it has been cooked?	
learning	What can happen if you attempt too much learning?	|communicating|getting|information|knowledge|listening|remembering|thinking
leaves	Where are leaves likely to cause an accident?	|plants
lemonade	If a person wants to make sure their lemonade is the most refreshing, where might they store it?	|bottle|carnival|drinking
lemur	Where might a lemur frolic in the market?	|encyclopedia
library	Where could you find a library that people of any age can visit?	|apartment|books|college|dictionary|property|school|shelf|warehouse
light	Where does light come from?	|current|lamp|motion|sun|sunshine
lights	There are lights for safety at what performance?	
liquid	They were making sauerkraut, the instructor explained the liquid should be above the cabbage in the what?	|bottle|drink|gas|glass|jar|water|wine
listening	What may you experience after listening to a boring talk for a long time?	|communicating|learning|remembering|understanding
living	John was living in a big city.  It had many roads and a lot of traffic.  He liked it, but didn't appreciate the smell.  He thought that there was too much what?	|cooking|dead|death|die|happiness|sadness
lizard	The lizard lived at the base of the ancient longest wall, what country did it likely live in?	|basement|grass|plants|rock|snake|tree
machine	Where might a milking machine be located?	|bus|car|computer|factory|house|meeting|work
magazine	From where would you take a magazine home without paying?	|book|books|dictionary|library|magazines|map|newspaper|pen
magazines	After perusal, a magazine will need such a resting place.	|books|magazine
map	Where might someone find a map on the wall?	|magazine|stuff
market	Where is a market likely to be enclosed?	|hospital|place|product|shop|sidewalk|store|street|village
marmoset	Where would you find out what a marmoset is?	
marmot	He knew of prairie dogs back home but wasn't sure if what he saw was a marmot, but the outback tour guide explained it was during his tour of where?	|dirt|forest|leaves
mess	He was a sloppy eater, so where did he leave a mess?	
money	Where can someone spend money?	|bank|change|debt|exchange|shop|wallet|work
moss	The moss was slippery because of constant moisture, what was nearby?	|forest|grass|leaves|trees
mountain	Where can you see a mountain in your own home?	|continent|earth|forest|ground|nature|rock|sky|tree
mouse	Where is someone likely to be unhappy to find a mouse nibbling on snacks?	|bee|cat|computer|cow|farm|field|food|squirrel
music	The music was loud do you know where it came from	|act|band|communication|dance|noise|play|singing|song
musician	Where can you find a single musician that an audience is listening to?	|band|music|orchestra|symphony
nails	Where would you put nails if they are already packaged?	|container|jar
newspaper	Billy was reading the newspaper as he commuted to work, but once he got to his destination he balled it up and put it somewhere. Where did it put it?	|article|book|books|magazine|magazines|paper
noise	There is a lot of noise in what group of people's homes and businesses?	|country|crowd|motion|music|place|radio|silence|voice
notebook	Where is a student likely to use a notebook?	|computer|desktop|pen|pencils|shelf
notes	He took meticulous notes, he wasn't naturally gifted but he worked very hard to do well at what?	
office	Where is the principal's office?	|city|company|desk|government|house|place|property|room
onions	James wanted onions but Sarah didn't want any. Because of this,  they split the what in half?	
paint	The old house had a loose window, this meant the what needed a coat of paint yearly?	|color|fire|floor|glass|painting|picture|sky|wood
pan	The food simmering in the pan smelled delicious, the aroma filled the entire what?	|container|kitchen|oven|pot
paper	If you get your paper back marked with corrections, where are you?	|book|case|desk|newspaper|pen|table|wood
papers	Where are you likely to set papers while working on them?	
paperwork	The man took paperwork to other people to consult over it, where was he heading?	|employees|meeting|workplace
passageway	A mom walks with laundry through the passageway, where is she?	|apartment|cellar|palace
peanuts	Sarah filled the thing with peanuts.  What did she fill with peanuts?	|jar
pebble	He picked up the perfect pebble, he planned to skip it across the entire small what?	|creek|pond
pen	where do you buy a pen?	|desk|magazine|notebook|paper
pencils	It was the first day and he was prepared, he had a whole pack of pencils in his what?	
people	Where might people gather to share information?	|arm|body|crowd|heart|human|humans|music|person
performing	Everybody began performing once their director stated what?	|act|anxiety|entertaining|singing
person	He kept plugging away in his cubicle, it seemed he was the only person not called into the what?	|body|company|dog|drink|human|office|party|people
picture	What periodical has articles and pictures?	|color|film|movie|painting|paper|wall
pie	Where can you store a pie?	|bowl|cheese|dinner|food|fruit|oven|pizza|refrigerator
pizza	From where is a pizza removed before it is served?	|food|oven|pie
plane	Where does a plane go when it has reached its destination?	|aircraft|airplanes|airport|birds|fly|wings
plants	What is covered in plants?	
plate	Where would my son place his paper plate?	|bowl|clock|cut|food|glass|paper|spoon|table
plates	Joe loved the smell of the food on their plates.  It really made his what flutter?	|cabinet
playing	What would happen if you want to win a game?	|fun|game|learning|play
poet	Where does a poet go when they're done at work?	|pen|song|speaker
pond	If there is a pond with trees around it, where it it likely located?	|bay|lake|ocean|pool
pot	Where would you put a pot if you do not need to use it?	|drawer|plants
potatoes	Where are you when an employee brings you cooked potatoes?	
president	The president keeps his pajamas where?	|country|government|head|office|state
prison	Many prison movies take place at what famous prison?	|buildings|jail
product	The doors closed to customers and he got to do his favorite part of the job, he began stocking product on the what?	|answer|exchange|groceries|market|shop|store
program	Which group is the cover for tonight's musical program?	|concert|demonstration|instruction|show
radio	He learned all about the radio for his extracurricular, it was his favorite memories of going to where?	|communication|garage|television
rain	What is rain a type of?	|fall|liquid|shower|sky|snow|summer|water|weather
refrigerator	Old refrigerators can often be stored where when not in use?	|cold|kitchen|oven
regret	He was beginning to regret taking the fight when he saw how what his opponent was?	|fear|grief|joy|like|pain|satisfaction|sorrow
remembering	Remembering your parents death can lead to what?	|knowledge|learning|pleasure|thinking
restaurant	The restaurant had no business out in the countryside, where should it move to?	|cafe|dinner|hotel|store|table
river	Where do you find an undiscovered river?	|bay|continent|current|ocean|pond|sea|stream|water
road	If you follow a road toward a river what feature are you driving through?	|bridge|car|country|ground|highway|river|roadway|street
roadway	A roadway doesn't have many building around it, where is it likely traversing?	|countryside|freeway|highway|road
rock	Where do you find a rock?	|dirt|earth|glass|ground|lizard|mountain|sea|tree
room	Although the living room was set up for the party, where did people tend to congregate while the mother worked?	|apartment|blanket|castle|closet|clothes|home|house|place
rosebush	What is the process of maintaining rosebushes in a lawn called?	|lawn
rug	The rug saw a lot of foot traffic and had popcorn strewn about, where was it likely?	|bedroom|blanket|book|carpet|ceiling|floor|shoes
seats	Where are the seats frequently covered in popcorn and soda?	|movie|movies|opera|show
security	Where would you install a security system?	|property
sex	What is likely the result of unprotected sex?	|fun
shelf	Where are you likely to find endless shelves?	|bathroom|books|cabinet|closet|library
shoes	Where might shoes be found under?	|books|carpet|clothing|dirt|floor|rug|shoe
silverware	Nate washed  his personal silverware and put it in a  drawer.   Where might that drawer be?	|kitchen|plates|spoon
skeleton	What has a keel in its skeleton?	
skin	The child tried to put a band-aid on the pet, his mom stopped him and explained they were only for skin of who?	|body
sleeping	She always made sure her infant was sleeping the right way, the articles she read had made her paranoid about what happening?	|dream|relaxation|sleep|snore
sloth	Jane turned to a random page and saw "sloth." What might she have been looking at?	|america|backyard|barn|bee|bench|ranch|town
snake	John felt a snake slither over him as he rested.  He was afraid to raise his covers for fear of startling it.  Where might he be?	|cat|creek|dirt|garden|grass|ground|lizard|rock
snow	The tourist was probably most happy to capture pictures of snow on what?	|cold|continent|earth|ground|heaven|rain|summer|weather
soup	Where might someone store homemade soup?	|bread|can|drink|fish|food|liquid|salad|wine
space	Where can you find all of space?	|air|earth|game|ground|place|room|run|sky
speaker	The speaker did what with the new product for the others?	|musician|shelf
squirrel	There was a sign telling picnickers not to feed squirrels, where was this sign likely placed?	|cat|farm|garden|grass|ground|street|tree|wood
staircase	Where kind of structure are you in if there is a fancy chandelier next to a staircase?	|climbing|stairs|stairwell
stamps	What part of some furniture could you put some stamps in?	
steakhouse	If I want to open a steakhouse, what should I get first?	|buildings|restaurant|suburb
stick	the dog brought a stick back to the house, the man could tell it came from a small area nearby, where was it likely from?	|ball|bone|cut|ground|mountain|nest|tree|wood
storage	James needed storage for 500 tons o beans in crates.  What sort of facility might he use?	|store|warehouse
stream	Where a small stream goes between farms?	|creek|forest|pool|river|swamp|wilderness
student	To learn something new, what is something an adult can take?	|class|classroom|college|desk|learning|school|teacher|university
stuff	The sloppy dad saw the random stuff in the kitchen, and saw space for it next to the glasses, where did he decide to place it?	|container|mail|papers|pen|shoes
sugar	Where would you get sugar if you do not have any?	|bread|desert|food|fruit|pie|snow
sunshine	What could sunshine light on fire if it is magnified?	|darkness|light|moon|rain|sky|summer|sun
table	What could you put a table on top of?	|chair|couch|desk|floor|house|plate|room|wood
talking	What should a person do before talking?	|communication|silence|talk|voice
telephone	What may I place the telephone on?	|communication|friends|meeting|talk
television	Where must a television be kept quiet?	
temple	What city in the middle east is known for a temple?	|apartment|church|jerusalem
toilet	The service was incredibly slow, he used the toilet twice during the what for his order where?	|bathroom|bathtub|jar|shower|sink|sky
town	A town between two mountains is located in a what?	|barn|city|country|house|ranch|store|village
trees	Where are trees likely to line a road?	|tree
trunk	Where would you find a trunk containing a spare blanket or pillow?	|attic|automobile|closet|forest
utensils	Where do most people keep utensils?	|pencils
vacuum	Where might an alien use a vacuum?	|dirt|dust
vase	Where would you put a vase to make sure the flowers inside it get enough sun?	
voice	What could you make with your voice?	|communicating|mouth|noise|silence|singing|song|talk|talking
water	What has water and mud in it?	|air|blood|can|drink|earth|liquid|ocean|sea
window	He remembered his family road trips fondly, sitting in the back seat of the what and staring out the window?	|door|floor|glass|house|room|space|table|wall
wine	Where do you buy a glass of wine?	|alcohol|beer|bottle|drink|drinking|glass|liquid|soup
wings	What has metal wings?	|airplane|airport|bird|butterflies|fly|plane
wood	Where would you get some wood if you do not have any?	|floor|ground|paper|plate|rock|stick|table|tree
yard	Where are there likely to be yards side by side?	|apartment|backyard|garden|grass|lawn|neighborhood|park
